XXXXXXXXXXXXXXXXXXXXXXXXXXXXXXXXXXXXXXXXXXXXXXXXXXXXXXXXXXXXXXXX
X                                                              X
X  XXXXXXXXXX                    XXXXXXXXXXXX                  X
X  X        X                    X          X                  X
X  X        X                    X          X                  X
X  X        X                    X          X                  X
X  X        XXXXXX               X          X                  X
X  X             X               XXXX  XXXXXX                  X
X  XXXXXX        X                  X                          X
X       X        X               X  X        XXXXXXXXXX        X
X                X     XXXXXXX   X  X        X        X        X
X       X        X           X   X  XX       X        X        X
X       XXXXXXXXXXXXXXXXXXX  XXXXX  XXXXXXXXXX        X        X
X                         X  X                        X        X
X                         X  X                        XXXXXXXXXX
X       XX XXXXXXXXXXX    X  X                                 X
X       X      X     X       XXXXX XXXXXXXXXXX  XXXXXXXXXXXXX  X
X       X      X     X            X             X              X
X       X            X            X             X              X
X       X   XXXX     XXXXXX       X             X              X
X       X                 X       X             XXXXXXX        X
X       XXXXXX            X  X    XXXXXXX            X X   X   X
X            X            X  X    X                  X X   X   X
X            X            X  X    X     X            X X   X   X
X            XXXXXX XXXXXXX  XXXXXX     XXX XXXXXXXXXX X   XX  X
X                     X   X       XX  XXX   X          X       X
X   XXXXXXXXXXX       X   c          c      X          X XXX   X
X   X         X       X  XXXXxxxxxXXXXXXXXXXXXXXX      X   X   X
X   X         X       X  X             X          XXXXXX   X   X
X   X         X          X             X          X            X
X   X         XXXXX      X             X          X        XXXXX
X   X            X X     X             XXXX       X            X
X   XXXXX   X    X X     XXXXXXX          X       XXXXXXXXXXXXXX
X       X   X    X X           X          X                    X
X       X   X    X XXXXX       X          XXXXXX               X
X       X   X          X       X               X               X
X       XXXXXXXXXX     X       XXXXXXXXXXXXXXXXXXXXXXXX        X
X          X     XXXX  X                              X        X
X       X     X        X                              X        X
X    XXXXXXXXXXXXXXXXXXXXXXX       XXXXXXXXXXX        X        X
X    X                     X       X         X        X        X
X    X                     X       X         X        XXXXXXXXXX
X    X                     X       X         X                 X
X    X                     XXXXX   X         X                 X
X    X                        X    XXXXXXXXXXX                 X
X    XXXXXXXXXXXXXXXXXX       X                                X
X                       X     X          XXXXXXXXXXXXXX        X
X                       X     X          X            X        X
X                       X     XXXXXXXXXXXX            X        X
X                       X                             X        X
X      XXXXXXXXXXXXXXXXXXXXXXXXX                      X        X
X      X                       X         XXXXXXXXXXXXX         X
X      X                       X         X                     X
X      X                       X         X                     X
X      X                       XXXXXXXXXXXXXXXXXX              X
X      X                                        X              X
X      X                                        X              X
X      XXXXXXXXXXXXXXXXXXXXXXXXXXXXXXXXXXXXXXXXXX              X
X                                                              X
X                                                              X
X                                                              X
X                                                              X
XXXXXXXXXXXXXXXXXXXXXXXXXXXXXXXXXXXXXXXXXXXXXXXXXXXXXXXXXXXXXXXX
